15 15 15 15 15 15 15 15 15 15 15 15 15 15 15 15 15 15 15 15 15 15 15 15 15 15 15 15 15 15 15 15
15 0 0 0 0 0 0 0 0 0 0 0 0 0 0 0 0 0 0 0 0 0 0 0 0 0 0 0 0 0 0 15
15 0 0 0 0 0 0 0 0 0 15 0 0 0 0 0 0 0 0 0 0 0 0 0 0 0 0 0 0 0 0 15
15 0 0 0 0 0 0 0 0 0 0 0 0 0 0 0 0 0 0 0 0 0 0 0 0 0 0 0 0 0 0 15
15 0 0 0 0 0 0 0 0 0 0 0 0 0 0 0 0 0 0 0 0 0 0 0 0 0 15 0 0 0 0 15
15 0 0 0 0 0 0 0 0 0 0 0 0 0 0 0 0 0 0 0 0 0 0 0 0 0 0 0 0 0 0 15
15 0 0 0 0 0 0 0 0 0 0 0 0 0 0 0 0 0 0 0 0 0 0 0 0 0 0 0 0 0 0 15
15 0 0 14 14 14 14 14 14 14 14 14 14 14 14 14 0 0 0 0 0 15 0 0 0 0 0 0 0 0 0 15
15 0 0 14 14 14 14 14 14 14 14 14 14 14 14 14 0 0 0 0 0 0 0 0 0 0 0 0 0 0 0 15
15 0 0 14 14 0 0 0 0 0 0 0 0 0 14 14 0 0 0 0 0 0 0 0 0 0 0 0 0 0 0 15
15 0 0 14 14 0 0 0 0 0 0 0 0 0 14 14 0 0 0 0 0 0 0 0 0 0 0 0 0 0 0 15
15 0 0 14 14 0 0 0 0 0 15 0 0 0 14 14 0 0 0 0 0 0 0 0 0 0 0 0 0 0 0 15
15 0 0 14 14 0 0 0 0 0 0 0 0 0 14 14 14 0 0 0 0 0 0 0 0 0 0 0 0 0 0 15
15 0 0 14 14 0 0 0 0 0 0 0 0 0 0 14 14 14 14 14 14 14 14 14 14 14 14 14 0 0 0 15
15 0 0 14 14 0 0 0 0 0 0 0 0 0 0 0 14 14 14 14 14 14 14 14 14 14 14 14 0 0 0 15
15 0 0 14 14 0 0 15 0 0 0 0 0 0 0 0 0 0 0 0 0 0 0 0 0 0 14 14 0 0 0 15
15 0 0 14 14 0 0 0 0 0 0 0 0 0 0 2 3 3 3 4 0 0 0 0 0 0 14 14 0 0 0 15
15 0 14 14 14 0 0 0 2 3 3 3 3 3 3 11 1 1 1 5 0 0 0 0 0 0 14 14 0 0 0 15
15 14 14 14 0 0 0 0 6 1 1 1 1 1 1 1 1 1 13 9 0 0 0 0 0 0 14 14 0 0 0 15
15 14 14 0 0 0 0 2 11 1 1 1 1 1 1 1 1 1 5 0 0 0 0 0 0 0 14 14 0 0 0 15
15 0 0 0 0 0 0 6 1 1 1 1 1 1 1 1 1 1 5 0 0 0 0 0 0 0 14 14 0 0 0 15
15 0 0 0 0 0 2 11 1 1 1 1 1 1 1 1 1 1 5 0 0 0 0 0 0 0 14 14 0 0 0 15
15 0 0 0 0 0 6 1 1 1 1 1 1 1 1 1 1 1 5 0 0 0 0 0 0 0 14 14 0 0 0 15
15 0 0 0 2 3 11 1 1 1 1 1 1 1 1 1 1 1 5 0 0 0 0 0 0 0 14 14 0 0 0 15
15 0 0 0 6 1 1 1 1 1 1 1 1 1 1 1 1 1 12 4 0 0 0 0 0 0 14 14 0 0 0 15
15 0 0 2 11 1 1 1 1 1 1 1 1 1 1 1 1 1 1 5 0 0 0 0 0 0 14 14 0 0 0 15
15 0 2 11 1 1 1 1 1 1 1 1 1 1 1 1 1 1 1 12 4 0 0 0 0 0 14 14 0 0 0 15
15 0 6 1 1 1 1 1 1 1 1 1 1 13 8 8 10 1 1 1 5 0 0 15 0 0 14 14 0 0 0 15
15 0 6 1 1 1 1 1 1 1 1 1 1 5 0 0 6 1 1 1 5 0 0 0 0 0 0 0 0 0 0 15
15 0 6 1 1 1 1 1 1 1 1 1 13 9 0 0 7 10 1 1 5 0 0 0 0 0 0 0 0 0 0 15
15 0 6 1 1 1 1 1 1 1 1 13 9 0 0 0 0 6 1 1 5 0 0 0 0 0 0 0 0 0 0 15
15 15 6 1 1 1 1 1 1 1 1 5 0 15 0 15 0 6 1 1 5 15 15 15 15 15 15 15 15 15 15 15